15
15
0,0,0,0,0,0,0,0,0,0,0,0,0,0,0
0, , , , , ,3,0,0,0,0,0,3, ,0
0, ,3,0,7, , ,2, , , ,f, , ,0
0, , ,0,0,4, , , ,3,0,0,4, ,0
0, ,o,0,8, , ,1, , , , , , ,0
0,0,0,0, ,0,0,0,0,0, , ,1, ,0
0, , ,2, ,0,0, ,0,0, ,6,0, ,0
0,4, , , , , ,s, , , ,3,0,z,0
0, ,6,1, ,0,0, ,0,0, , ,0, ,0
0, ,3,0, ,0,0, ,0,0, , ,2, ,0
0, , ,5,0,8, , , , , , , , ,0
0,4, ,0,0, ,3,4, ,3,0,0,4, ,0
0, , ,o,0, , , , , ,5,0,o, ,0
0, , , , , ,1, ,1, ,z,0, , ,0
0,0,0,0,0,0,0,0,0,0,0,0,0,0,0