15
15
0,0,0,0,0,0,0,0,0,0,0,0,0,0,0
0,8, , ,0,8,5,0,0,8, ,0, ,o,0
0, , , , , , , , , , , ,z, ,0
0, ,0,0,0, ,0,0,4, ,0,0, ,0,0
0, ,0,8, , ,0,8, , ,0,0, , ,0
0,o,0,s, , ,0, , , ,2, , , ,0
0,0,0,0, ,0,0, , , , ,6,1, ,0
0, , ,2, ,5,0,0,4, ,3,0,0,f,0
0, , , , , ,5,0, , , ,5,0,0,0
0, ,1, , ,1, ,0,7, , , ,5,0,0
0, ,0,7, ,2, ,0,0,0,0,4, ,5,0
0, ,0,0, , , ,0, ,z,0,o, , ,0
0, ,2, , , ,3,0, ,3,0,0,4, ,0
0,7, , ,1, , , , , , , , ,6,0
0,0,0,0,0,0,0,0,0,0,0,0,0,0,0