15
15
0,0,0,0,0,0,0,0,0,0,0,0,0,0,0
0, , , ,z, , , , , , , , , ,0
0, ,0,0,0,0,0, ,0,0,o, , , ,0
0, , , , ,5,0, ,0,0,0,4, , ,0
0, ,0,0,0, ,0, , , , , , , ,0
0, ,0,f,0, ,0, ,0,0,7,0,1, ,0
0, ,0,7, , ,0, ,0,0,0, ,0, ,0
0, ,0,0,0, ,0, , , ,0, ,0,s,0
0, ,0,z, , , , , , ,2, ,0, ,0
0, ,0,0,4, ,3,0,0, , , ,2, ,0
0, , , , , , ,6,0, , , , , ,0
0, ,3,0,0,4, ,3,0,0, ,3,4, ,0
0, , ,0,0,o, , ,5,0, , ,o, ,0
0, , , , , ,1, , , , , , , ,0
0,0,0,0,0,0,0,0,0,0,0,0,0,0,0