15
15
0,0,0,0,0,0,0,0,0,0,0,0,0,0,0
0, , , , , , , , ,s, , , , ,0
0,0,4, ,3,0,0,0,0,0,0,0,0, ,0
0,o, , , , , , ,z, , , ,2, ,0
0, ,0,0,4, ,3,0,0,0,0, , , ,0
0, ,0, , , , , , , ,2, ,1, ,0
0, ,0, ,0,0,0,0,0, , , ,0, ,0
0, ,0, ,0,z, ,f,0, ,1, ,0, ,0
0, ,0, ,2, ,3,0,0, ,0, ,2, ,0
0, ,0, , , , , , , ,0, , , ,0
0, ,0, ,3,0,0,0,0,0,0, ,1, ,0
0, ,0,o, , , , , , , ,z,0, ,0
0, ,0,4, ,3,0,0,0,0,0,0,0, ,0
0, , , , , , , , , , , , ,o,0
0,0,0,0,0,0,0,0,0,0,0,0,0,0,0